1111111111111111111111111111111111
1PC0C1C1C1C1C1C1C0C1C1C1C1C1C1C101
11000000000000000E0000000000000011
1C010101010101010101111111111110C1
110101010101010101010101010101C011
1C011111111111110101111111111110C1
1101010101010101010000000000000011
1C011111111111110101111111111110C1
110101010101010101010101010101C001
1C010101010101010101111111111110C1
1100000000000000010000000000000011
1C01C1C01C1C1C1C111C1C1C1C1C1C1C01
1111111111111111111111111111111111
