11111111111111111111111111111111111
1E00100C00C00C000010000000000010001
100100000C000000C100000C000000C0011
1P000000000010000000C000000100C0001
11111111111111111111111111111111111
