1111111111111
10010000000C1
11E0011111001
1P00110000001
1111111111111
