111111111111111111
1000001P1E00000001
100000100000000001
10000011100000C001
111111111111111111
